<item>
<title>CD 2</title>
<link>https://od.lk/s/OTdfMzQ1Mjk3N18/now%2095%20cd2.mp4</link>
<thumbnail>https://od.lk/s/OTdfMzQ1Mjk3MV8/Cover.jpg</thumbnail>
<fanart></fanart>
<info>23. DJ Snake feat. Justin Bieber	Let Me Love You
24. Fifth Harmony	That's My Girl
25. Sigma feat. Birdy	Find Me
26. Martin Garrix & Bebe Rexha	In The Name Of Love
27. Nevada feat. Mark Morrison & Fetty Wap	The Mack
28. TIEKS feat. Dan Harkna	Sunshine
29. Zara Larsson	Ain't My Fault
30. Bob Marley & The Wailers feat. LVNDSCAPE & Bolier	Is This Love (Remix)
31. Digital Farm Animals & Cash Cash feat. Nelly	Millionaire
32. Snakehips feat. ZAYN	Cruel
33. Matoma & Becky Hill	False Alarm
34. Galantis & Hook N Sling	Love On Me
35. Charli XCX feat. Lil Yachty	After The Afterparty
36. Dua Lipa	Blow Your Mind (Mwah)
37. Louisa Johnson	So Good
38. James TW	When You Love Someone
39. Wilkinson feat. Karen Harding	Sweet Lies
40. Craig David & Sigala	Ain't Giving Up
41. Charlie Puth	Dangerously
42. offaiah	Trouble
43. Christine And The Queens	Tilted
44. Lady Gaga	Perfect Illusion
45. Niall Horan	This Town</info>
</item>


